NO textures/redbrick.png 



SO textures/redbrick.png
WE textures/wood.png




EA textures/redbrick.png

DO textures/pikuma.png

F 132,165,157

C 242,132,130 


11111111111111111111111111111111
100000000000000000000000000000001
1000011D10000000000000000000000001
1000000N000000000000000000011111111
10000000000000100000000000001111111
111111111111111111111111111111
